{
    "width": 30,
    "height": 20,
    "tiles": [
        "==============================",
        "=                            =",
        "= p                          =",
        "=========  ===========       =",
        "=                            =",
        "======== ====== = =          =",
        "=                   ==       =",
        "=                            =",
        "=              s ===         =",
        "=             ===            =",
        "=                            =",
        "=        ===           =======",
        "=                            =",
        "=                            =",
        "=      ==   =    =           =",
        "=                            =",
        "=                            =",
        "=               =            =",
        "=                            =",
        "=============================="
    ],
    "baddies": [
    ]
}

