{
    "width": 30,
    "height": 20,
    "tiles": [
        "==============================",
        "=                            =",
        "=          1                 =",
        "=========  ===========       =",
        "=                            =",
        "======== ====== = =          =",
        "=                   ==       =",
        "=          2                 =",
        "=                ===         =",
        "=             ===            =",
        "=         4            p     =",
        "=      = ===           =======",
        "=      =                     =",
        "=      =                     =",
        "=      ==   =    =           =",
        "=      =             3       =",
        "=      =                     =",
        "=      =        =            =",
        "=  s   =                     =",
        "=============================="
    ],
    "baddies": [
        {
            "type": "walker",
            "start": 1
        },
        {
            "type": "walker",
            "start": 2
        },
        {
            "type": "bouncer",
            "start": 4
        },
        {
            "type": "pathFollower",
            "start": 3,
            "path": "lLluUurRrdDd"
        }
    ]
}

        
        