{
    "width": 30,
    "height": 20,
    "tiles": [
        "==============================",
        "=                            =",
        "=          1         4       =",
        "=========  ===========       =",
        "=                            =",
        "======== ====== = =          =",
        "=                   ==       =",
        "=                            =",
        "=                ===         =",
        "=             ===            =",
        "=         2            p     =",
        "=      = ===           =======",
        "=      =                     =",
        "=      =                     =",
        "=      ==   =    =           =",
        "=      =             3       =",
        "=      =                     =",
        "=      =        =            =",
        "=  s   =                     =",
        "=============================="
    ],
    "baddies": [
        {
            "type": "walker",
            "start": "1"
        },
        {
            "type": "walker",
            "start": "2"
        },
        {
            "type": "bouncingBall",
            "start": "4"
        },
        {
            "type": "pathFollower",
            "start": "3",
            "path": "lLluUurRrdDd"
        }
    ]
}

        
        