{
    "width": 30,
    "height": 20,
    "tiles": [
        "==============================",
        "=   s                        =",
        "=                            =",
        "=========  ===========       =",
        "=                            =",
        "======== ====== = =          =",
        "=                   ==       =",
        "=                            =",
        "=                ===         =",
        "=             ===            =",
        "=                            =",
        "=        ===           =======",
        "=                            =",
        "=                            =",
        "=======================      =",
        "=                            =",
        "=               p            =",
        "=               =            =",
        "=                            =",
        "=============================="
    ],
    "baddies": [
    ]
}

